../\/\..../\../\../\../\/\
..\@ /.../ /..\ \/  \.\  /
../  \../  \/\.\  /\ \/ /.
./ /\/./ /\  /./  \.\  /..
/ /.../  \.\ \/ /\ \.\/./\
\ \../ /\ \.\  /./  \../X/
.\ \/ /./ /./ /./ /\ \/ /.
..\  /./ /./ /..\ \.\  /..
...\/..\/..\/....\/..\/...